'		そ
,		け
.		せ
p		て
y	ょ
f		つ
g	ん
c	の
r	を
l	り
/		ち
a		は
o		か
e		し
u		と
i		た
d		く
h	う
t	い
n	゛
s		き
-	な
;		す
q		こ
j	に
k		さ
x	あ
b	っ
m	る
w	、
v	。
z	れ
"	ぁ
<	゜
>		ほ
P		ふ
Y	め
F		ひ
G	え
C	み
R	や
L	ぬ
?	「
+	」
A	ぃ
O		へ
E	ら
U	ゅ
I	よ
D	ま
H	お
T	も
N	わ
S	ゆ
_	？
:	ぅ
Q	ぇ
J	ぉ
K	ね
X	ゃ
B	む
M	ろ
W	・
V	ー
かn	が
きn	ぎ
くn	ぐ
けn	げ
こn	ご
さn	ざ
しn	じ
すn	ず
せn	ぜ
そn	ぞ
たn	だ
ちn	ぢ
つn	づ
てn	で
とn	ど
はn	ば
ひn	び
ふn	ぶ
へn	べ
ほn	ぼ
は<	ぱ
ひ<	ぴ
ふ<	ぷ
へ<	ぺ
ほ<	ぽ


